WWWWWWWWWWWW
WOOOOWOOOOWW
WWWWOOOWWWWW
WWOWOWWOOOOW
WOOOOOOOOOOW
WOOOOOWOOOOW
WOOOOOOOOOOW
WWWWWWWWWWWW