WWWWWWWWWWWWWWWWWWWW
WOOWWWOOOOOOOOOOWOFW
WWOOOOOOOOOOOOOOOOOW
WOWWWWWWWWOWOWWWOWWW
WOOOOOOOOOOWOOOOWWOW
WWWWWWWWWWWWWOWOWWOW
WWWWOWOWWWWWWOWOOWOW
WOWOOWOWWWWOOOWOWOOW
WOOOWOOWOWWOWWWOWOWW
WOWOWWOWOWOOWWWOWOOW
WHOOOOOOOOOOOOOOOOOW
WWWWWWWWWWWWWWWWWWWW
